urlHelp=help/index.html
lastSaved=Last Saved
currentFile=Arquivo Atual
toolbar=Ferramentas
save=Salvar
print=Imprimir
cut=Recortar
copy=Copiar
paste=Colar
delete=Deletar
undo=Desfazer
redo=Refazer
select=Selecionar
connect=Conectar
pan=Pan
zoomIn=Aumentar Zoom
zoomOut=Diminuir Zoom
zoom=Zoom
fit=Ajustar a tela
actualSize=Zoom Atual
selectAll=Selecionar Todos
clearSelection=Limpar Seleção
shape=Forma
format=Formato
font=Fonte
group=Agrupar
ungroup=Desagrupar
removeFromParent=Orphan
align=Alinhar
left=Esquerda
right=Direita
center=Centralizar
top=Topo
middle=Meio
bottom=Fundo
collapse=Collapse
expand=Expandir
toBack=Enviar para trás
toFront=Enviar para frente
enterGroup=Inserir no Grupo
exitGroup=Retirar do Grupo
layout=Layout
horizontalTree=Árvore Horizontal
verticalTree=Árvore Vertical
fillColor=Cor de Preenchimento
strokeColor=Cor da Linha
gradientColor=Cor do Gradiente
bold=Negrito
italic=Italico
fontColor=Cor da Fonte
fontSize=Tamanho da Fonte
fontFamily=Fonte
examples=Examples
newDiagram=New Diagram
image=Imagem
opacity=Opacidade
selection=Seleção
editStyle=Edit Style
enterStyle=Enter Style
enterColorname=Enter Colorname
enterImageUrl=Enter Image URL
enterOpacity=Enter Opacity (%)
enterFontsize=Enter Fontsize (pt)
enterFontfamily=Enter Fontfamily
toggleRounded=Rounded
toggleShadow=Shadow
openHref=Open URL
show=Visualizar
exportImage=Exportar Imagem
exportSvg=Exportar SVG
changesLost=Todas as alterações serão perdidas!
swimlanes=Swimlanes
travelBooking=Travel Booking
notAvailable=Indisponível
